-1 -1 4 -1 2 2 -1 -1 -1 -1 -1
-1 -1 4 -1 0 0 -1 -1 -1 -1 -1
-1 -1 4 -1 0 0 2 2 -1 -1 -1
-1 -1 4 -1 0 0 2 2 -1 -1 -1
-1 -1 4 -1 6 0 -1 0 4 4 -1
-1 -1 4 -1 6 0 -1 0 2 2 -1
-1 -1 4 -1 6 0 -1 0 2 2 -1
-1 -1 4 2 6 0 -1 0 0 0 -1
-1 -1 6 6 6 0 -1 0 0 0 -1
-1 -1 -1 -1 -1 -1 -1 0 0 0 -1
-1 -1 -1 -1 -1 -1 -1 -1 -1 -1 -1
